# # # # # # # # # # # # # # # # # # # # # # # # # 
# A   # . . . . # # . . . . . . . # # . . . . # # 
# #     . . . . . # # # . # . . . . # # # . . . # 
#     . # . . . . . # . . . . # # . # . . . # . # 
# . # # # # . # . . # . . # # . . # # . . . # # # 
# . # . . . # # . # . . . . # . . # # . . . . . # 
# . # . . . . # # . # . # . # . # . . # # . . . # 
# . . . # . . # . # # . . . # # . . . . # . . . # 
# . . . . . . . . . # . . . # # . . # . . . . . # 
# . . # . . . . . # . . . . # # # . . . . . . . # 
# . . . # # # # . # . # # . . . . . . # . . . . # 
# # . # . . # # . . . . # . # . . . . . . # . . # 
# # . . # . . # # . . . # . . # # . # # . . # . # 
# . . # . # . . . . # . . . . # # . # . . . . . # 
# # . . # # # . # # . # . . . . # # . . # . # # # 
# . # . . . . # . . . . . . # . . # . # . . . . # 
# . # . . # . . . # . . . . . . . . # . . # # . # 
# # . . . . . # . # . . . . . . . . . . . . . # # 
# # . . . . . . # # # . . # # # # # . . # . . . # 
# # # . # . # . # # . . . . . # . . . # # . . . # 
# . # # . # . # # . . . . . . . . # . .     # # # 
# . . . # . . . . . . # # # . . # . .         B # 
# # # # # # # # # # # # # # # # # # # # # # # # # 

