# # # # # # # # # # # # # # # # # # # # # # # # # 
# A         . . . . . . . . . . . . . . . . . . # 
#   #   #   # . # . # . # . # . # . # . # . # . # 
#   .       . . . . . . . . . . . . . . . . . . # 
#   #   #   # . # . # . # . # . # . # . # . # . # 
#   . . .   . . . . . . . . . . . . . . . . . . # 
#   # . # . # . # . # . # . # . # . # . # . # . # 
# . . . . . . . . . . . . . . . . . . . . . . . # 
# . # . # . # . # . # . # . # . # . # . # . # . # 
# . . . . . . . . . . . . . . . . . . . . . . . # 
# . # . # . # . # . # . # . # . # . # . # . # . # 
# . . . . . . . . . . . . . . . . . . . . . . . # 
# . # . # . # . # . # . # . # . # . # . # . # . # 
# . . . . . . . . . . . . . . . . . . . . . . . # 
# . # . # . # . # . # . # . # . # . # . # . # . # 
# . . . . . . . . . . . . . . . . . . . . . . . # 
# . # . # . # . # . # . # . # . # . # . # . # . # 
# . . . . . . . . . . . . . . . . . . .         # 
# . # . # . # . # . # . # . # . # . # . # . #   # 
# . . . . . . . . . . . . . . . . . . . .       # 
# . # . # . # . # . # . # . # . # . # . #   #   # 
# . . . . . . . . . . . . . . . . . . .       B # 
# # # # # # # # # # # # # # # # # # # # # # # # # 
