# # # # # # # # # # # # # # # # # # # # # # # # # 
# A       .   . . . .   . .       . .   .   . . # 
#   # . #   #   #   # . #   # . # . #   # . # . # 
# . . .     . . .   . . . . .   . . . .         # 
# . # . # . # . # . # . # . #   # . # . # . # . # 
#   . . . .     . . . . . . . .     . .   . . . # 
#   #   #   # . # . #   #   #   # . # . # . # . # 
# .   .     . . .   . .   .   . . .   . .   . . # 
# . # . # . # . #   # . # . #   # . #   # . #   # 
# .     . .     . . . . .   . . . . .   . .   . # 
#   #   #   #   # . # . # . # . # . # . # . # . # 
#   . . . . . . . . . . . .   . . . . .     . . # 
# . # . #   # . # . # . # . # . # . #   #   # . # 
# . . .     . . .     . . . . .   . . .     .   # 
# . # . # . # . # . # . # . # . #   # . #   # . # 
# .     .       .   . .     . . . .         .   # 
# . #   # . # . # . # . # . #   # . #   #   # . # 
# . . . . . . .   .   . . .   .           .     # 
#   #   # . #   # . #   # . # . # . # . # . # . # 
# .   . .   . . . . . . .   .   .   . . .       # 
# . # . # . #   #   #   # . # . # . # . #   #   # 
#   . .     . . . .     . . .     . . .       B # 
# # # # # # # # # # # # # # # # # # # # # # # # # 
