# # # # # # # # # # # # # # # # # # # # # # # # # 
# A         . . . . . . . . . . . . . . . . . . # 
#   #   #   # . # . # . # . # . # . # . # . # . # 
#   .       . . . . . . . . . . . . . . . . . . # 
#   #   #   # . # . # . # . # . # . # . # . # . # 
#   . . .   . . . . . . . . . . . . . . . . . . # 
#   # . #   # . # . # . # . # . # . # . # . # . # 
# . . . .   . . . . . . . . . . . . . . . . . . # 
# . # . #   # . # . # . # . # . # . # . # . # . # 
# . . . .               . . . . . . . . . . . . # 
# . # . # . # . # . #   # . # . # . # . # . # . # 
# . . . . . . . . . .   . . . . . . . . . . . . # 
# . # . # . # . # . #   # . # . # . # . # . # . # 
# . . . . . . . . . .   . . . . . . . . . . . . # 
# . # . # . # . # . #   # . # . # . # . # . # . # 
# . . . . . . . . . .   . . . . . . . . . . . . # 
# . # . # . # . # . #   # . # . # . # . # . # . # 
# . . . . . . . . . .   . . . . . . . .         # 
# . # . # . # . # . # . # . # . # . # . # . #   # 
# . . . . . . . . . . . . . . . . . . . .       # 
# . # . # . # . # . # . # . # . # . # . #   #   # 
# . . . . . . . . . . . . . . . . . . .       B # 
# # # # # # # # # # # # # # # # # # # # # # # # # 

